000000000000
0   6758   0
000000000000
0          0
0    2     0
0       1  0
0          0
0         00
0     9    0
0         00
000000000000