000000000000000000000000
0                S     0
07                4    0
08             3       0
000  2                 0
070     1              0
000        6           0
090       0            0
080                    0
0 00                  00
000000000000000000000000