011111111011111111111110
23       2  9   4  5   2
0111111052      2  5   2
2        2      2  5   2
2        2      2      S
2        2      01111112
2511111110      5     82
2        2      2      2
2   555  011111105011112
26       5        5   72
011111111011111111111110