011111111011111111111110
23      92   8  4  5   2
0    11052      2  5   2
2        2      2  5   2
2        2  7   2     6S
2        2      01111112
2 11111110      5      2
2        2      2      2
2   555  011111105011 12
2        5        5    2
011111111011111111111110

000000000               
0 0 0 0 0               
000000000               