000000000000000000000000
0                S     0
09        0       4    0
08        0    3       0
000  2    0            0
070    1  0            0
0         0            0
00                     0
0           6          0
0 00                  00
000000000000000000000000