000000000000000000000000
06                     0
07                     0
08             3       0
000  2                 0
070     1              0
000                    0
0904      0            0
080                    0
0 00                  00
000000000000000000000000