011111111111111111111110
2 6       3        7   2
2110 01110 0110 01111112
2  2 2   2 2  2 2      2
2      2    2          2
011111105555501111111110
2                      2
2        2    2        2
2        2    2    5   2
2   4    2 98 2    5   2
0111111111111111111S1110